##########
#M......)#
#.M....).#
#..M..)..#
#....@...#
#...)M...#
#..)..M..#
#.)....M.#
#......X.#
##########