##########
#@#......#
#.#.####.#
#.#....#.#
#.#.##.#.#
#.#.M#.#.#
#.#....#.#
#.######.#
#......X.#
##########