##########
#........#
#.M......#
#........#
#....@...#
#........#
#.....!..#
#........#
#......X.#
##########