##########
#.M..]...#
#....M...#
#........#
#....@...#
#....!...#
#..M.....#
#........#
#......X.#
##########