##########
#.M......#
#......).#
#........#
#....@...#
#....M...#
#........#
#........#
#......X.#
##########